Jews : yahoodies
advice : soviet
ancient : starry
annoy : razdraz
arrogant : nadmenny
bad : baddiwad
band : banda
barrier : shest
bastard : bratchny
battle : bitva
beak : cluve
beast : scoteena
bell : collocoll
bellpull : zvonock
belly : brooko
big : bolshy
blood : cables
body : plott
boohoohoo : boohoo
bothered : fashed
boy : malchick
brain : mozg
brainy : oomny
bratty : brat
bread : kleb
breast : groody
brosat : brosay
butter : maslo
buttocks : sharries
button : knopka
buttoning : knopkavat
caught : loveted
cell : Staja
chain : oozy
charlie : charles
chickenfeed : hen-korm
cigarette : cancer
cinema : filmdrome
clothes : platties
clothing : koshtoom
club : shlaga
clubbed : shlagnicked
concern : shilarny
corny : hound-and-horny
cough : kashl
cow : korova
crap : cal
criminal : prestoopnik
cup : chasha
dear : dorogoy
dedoochka : ded
dirty : grahzny
dream : sneety
drug : drencrom
drugs : knives
drums : timps
drunk : pyahnitsa
ear : ooko
egg : eggiweg
erection : pan-handle
eyeglasses : otchkies
face : litso
feet : nogas
female : sharp
fighting : dratsing
filthy : merzky
food : pishcha
fool : nazz
friend : droog
frightened : poogly
game : eegra
gang : shaika
generous : sammy
girl : kisa
girl : ptitsa
glazzies : glazz
glory : luscious
good : horrorshow
group : gruppa
guard : chasso
gun : pooshka
guts : guttiwuts
guts : keeshkas
hair : voloss
handful : rookerful
handkerchief : tashtook
hat : shlapa
head : gulliver
heart : tick-tocker
helmet : shlem
hole : stripey
hole : yahma
home : flatblock
horror : strack
house : domy
it : snuff
jam : jammiwam
jelly : eunuch
joy : radosty
key : klootch
knife : nozh
knocky : oddy
kot : koshka
lady : dama
laugh : smeck
library : biblio
life : jeezny
lip : goober
little : malenky
loud : gromky
mad : bezoomny
making : lubbilubbing
man : moodge
mechanically : clockwork
milk : moloko
mind : rassoodock
minute : minoota
money : cutter
moon : luna
mother : em
mouth : rot
munching : munchy-wunching
naked : nagoy
name : eemya
neck : shiyah
newspaper : gazetta
night : nochy
nochy : this
noise : shoom
nonsense : chepooka
office : cantora
old : soomka
one : odin
paw : lapa
people : lewdies
person : chelloveck
piece : lomtick
pillow : podooshka
place : mesto
plus : Moloko
pocket : carman
police : millicents
policeman : rozz
polly : pretty
potatoes : kartoffel
priest : godman
prisoner : plenny
punching : punchipunching
push : tolchock
quick : skorry
rapido : espresso
razor : britva
remarkable : zammechat
rich : bugatty
riches : bugatties
rooker : rook
sarcastic : sarky
satellite : worldcast
school : skolliwoll
scratching : skriking
scratchy : fuzzy
see : viddy
sex : pol
shiny : silver-like
shoe : sabog
shoulder : pletcho
sick : bolnoy
skeleton : polyclef
sleep : zasnoot
slice : shive
slippers : toofles
slooshy : sloosh
smell : von
smelling : nuking
snack : mounch
snout : morder
soiled : grazzy
songs : warbles
sound : zvook
spatchka : spat
speak : govoreet
splash : plesk
splosh : splodge
steal : crast
story : raskazz
strong : firegold
stupid : gloopy
sugar : sakar
sweet : sladky
sweetest : sladkvat
take : shvat
tea : chai
teenage : nadsat
teeth : zoobies
terrible : oozhassny
terrified : spoogy
thing : veshch
thought : messel
three : tree
throat : gorlo
time : raz
tire : fag
tired : faggy
tobacco : snoutie
tongue : yahzick
trace : dook
trout : forella
two : dva
underpants : neezhnies
unit : golly
useful : polezny
voice : goloss
waist : tally
washroom : vaysay
weep : blub
whore : sooka
wife : zheena
wild : flip
window : okno
wine : vehina
wine : vino
woman : cheena
wonderful : choodessny
word : slovo
work : rabbit
yarblockos : yarbles
young : devotchka
young : molodoy
